Björk – Vulnicura
Torres – Sprinter
Eartheater – Rip Chrysalis
Cotillon – Cotillon
Alex Calder – Strange Dreams
Jenny Hval – Apocalypse, girl
Joan Shelley – Over and Even + 3
Nils Frahm – Screws Reworked
EMA – #Horror Original Score
A Sunny Day In Glasgow – New Christmas Classics
PRhyme – PRhyme (Deluxe Version)
Margot & The Nuclear So And So's – (Best Of) The Bride On The Boxcar - A Decade of Margot Rarities: 2004-2014
Milo – So the Flies Don't Come
El Ten Eleven – Fast Forward
Bibio – Fi
Erykah Badu – But You Caint Use My Phone (Mixtape)
Margot & The Nuclear So And So's – The Bride on the Boxcar - A Decade of Margot Rarities, 2004-2014
Sunn 0))) – Kannon
Hop Along – Painted Shut
Parquet Courts – Monastic Living
Oneida – Positions
Foo Fighters – Saint Cecilia EP
RHODES – Wishes (Deluxe Version) 2
Widowspeak – All Yours
Arca – Mutant
Bing & Ruth – City Lake
Night Beds – Night Beds on Audiotree Live
The Drink – Capital
Royce Da 5'9" – Build & Destroy
Brad Mehldau – 10 Years Solo Live
The Pains Of Being Pure At Heart – Hell
Grimes — Art Angels
Video – The Entertainers
The Drink – Company
Car Seat Headrest – Teens of Style
Timmy's Organism – Heartless Heathen
Beach Slang – The Things We Do To Find People Who Feel Like Us
Tall Tales & The Silver Lining – Unknown Forces EP
Young Galaxy – Falsework
EL VY – Return To The Moon
Lone – Once In A While / Raptured
Mothers — Mothers on Audiotree Live
Mothers — It Hurts Until It Doesn't - Single
Various Artists – Brown Acid - The First Trip
Wolf Alice – My Love Is Cool
Slaves – Are You Satisfied?
Róisín Murphy – Hairless Toys
Ghostpoet – Shedding Skin
Gaz Coombes – Matador
Benjamin Clementine – At Least For Now
Neon Indian – Vega Intl. Night School
Bert Jansch – Moonshine
Chris Forsyth – The Island
Gun Outfit – Dream All Over
Majical Cloudz – Are You Alone?
Small Black – Best Blues
Hercules & Love Affair – Blue Songs
Deerhunter – Fading Frontier
Beach House — Thank Your Lucky Stars
Car Seat Headrest – How to Leave Town
Downtown Boys – Full Communism
Ryan Hemsworth – Taking Flight
Protomartyr – The Agent Intellect
The Districts – A Flourish and a Spoil
Weyes Blood – Cardamom Times
Speedy Ortiz — Sports
Express Rising – Fixed Rope
Mourn – Gertrudis
Animal Collective – Live at 9:30
U.S. Girls – Half Free
Steven A. Clark – The Lonely Roller
Roseau – Salt
Ought – Sun Coming Down
Youth Lagoon – Savage Hills Ballroom
New Order – Music Complete
Dungen – Allas Sak
Kurt Vile – b'lieve i'm goin down...
Julia Holter – Have You In My Wilderness
Girl Band – Holding Hands With Jamie
Disclosure – Caracal
CHVRCHES – Every Open Eye
Lone – Ecstasy & Friends
Circa Waves – Young Chasers
Stars – Lost & Found
Metric – Pagans in Vegas
Yung – These Thoughts Are Like Mandatory Chores
Battles – La Di Da Di
Darwin Deez – Double Down
Blackalicious – Imani Vol. 1
Meat Wave – Delusion Moon
RHODES – Wishes (Deluxe Version)
The Scientists – Blood Red River
The Scientists – The Scientists
Pat Patrick & The Baritone Saxophone Retinue – Sound Advice
Stephen O'Malley – Eternelle Idole
Holly Golightly – Slowtown Now!
Hinds – Very Best of Hinds so Far
Self Defense Family – Two Genuine Oddities From Our Distant Past
Vacation – The Do Shit Wax
Allah-Las – Aquarium Drunkard's Lagniappe Session
Empress Of – Me
LOWER – I'm A Lazy Son... But I'm The Only Son
Beirut — No No No
Beach House – Depression Cherry
Atlas Genius – Inanimate Objects
Yo La Tengo – Stuff Like That There
Foals – What Went Down
AUTOBAHN – Dissemble
Domenique Dumont – Comme ça
circe soundtrack
Panda Bear – Crosswords EP
The Impressions – 15 from the Impressions
FKA twigs – M3LL155X
Beak> – Split EP
Lizzy Mercier Descloux – Press Color (Deluxe Edition)
Zachary Cale – Sundowner + 3
Jamaican Queens – Downers
Sylvan Esso – H.S.K.T. (Digital Version)
Ultimate Painting – Green Lanes
Night Beds – Ivywild
Aero Flynn – Aero Flynn
Ghostface Killah – Adrian Younge Presents: Twelve Reasons to Die II (Deluxe)
M.E.S.H. – Piteous Gate
FIS – The Blue Quicksand Is Going Now
Mbongwana Star – From Kinshasa
Lianne La Havas – Blood
Kamasi Washington – The Epic
Mac Demarco – Another One
Wye Oak – Shriek Remixes
Titus Andronicus – The Most Lamentable Tragedy
Ducktails — St. Catherine
Ratatat — Magnifique
Chris Staples – Cheap Shades EP
Sleaford Mods – Key Markets
Strand of Oaks – HEAL (Deluxe Edition)
Lone – Lemurian
C. Duncan – Architect
Wilco – Star Wars
Courtney Barnett – Spotify Sessions 2
Twin Peaks – Spotify Sessions
Tame Impala – Currents
Mammoth Penguins – Hide and Seek
Wavves/Cloud Nothings – No Life for Me
Chastity Belt – Time to Go Home
Waitress – Bilbao
Self Defense Family – Heaven Is Earth
LA Priest – Inji
Panda Bear – PBVSGR Remixes
Bruce Brubaker – Glass Piano
In Camera – Era
Desaparecidos – Payola
Leon Bridges – Coming Home
Thundercat – The Beyond / Where the Giants Roam
High Wolf – Growing Wild
Porcelain Raft – Half Awake EP
Joanna Gruesome – Peanut Butter 2
George Ezra – Wanted On Voyage
Seoul – I Become A Shade
Heitor Alvelos – Faith
Boof – The Hydrangeas Whisper
Alex Chilton – Ocean Club '77
Sharon Van Etten – I Don't Want to Let You Down
PINS — Wild Nights
Tall Tales & The Silver Lining – Tightropes
Algiers – Algiers
Daughn Gibson – Carnation
Kinski – 7 (or 8)
Jamie xx – In Colour
SOAK – Before We Forgot How To Dream
Girlpool – Before The World Was Big
Sun Kil Moon — Universal Themes
Joshua Redman – The Bad Plus Joshua Redman
Unknown Mortal Orchestra – Multi-Love
Delicate Steve – Delicate Steve Live in Las Vegas
Shopping – Consumer Complaints
Tanlines – Highlights
AURORA – Running With The Wolves
Hot Chip – Why Make Sense?
Joanna Gruesome – Peanut Butter
My Brightest Diamond – I Had Grown Wild
Total Babes – Heydays
Penguin Prison – Lost in New York
Blanck Mass – Dumb Flesh
D'Angelo – Spotify Sessions
Surfer Blood – 1000 Palms
Guess What – Al Khawarizmi
Other Lives – Rituals
Colin Stetson – Never Were the Way She Was
Braids – Deep In the Iris
Gabriel Mayers – Gabriel Effing Mayers
Tyler, The Creator – Cherry Bomb
Great Lake Swimmers – A Forest of Arms
Built To Spill – Untethered Moon
San Fermin – Jackrabbit
Speedy Ortiz – Foil Deer
The Mowgli's – Kids In Love
Pinkshinyultrablast – Everything Else Matters
Matt and Kim – New Glow
Jukebox The Ghost – Jukebox The Ghost
Young Fathers – White Men Are Black Men Too
Waxahatchee – Ivy Tripp
Bear In Heaven – Spotify Sessions
Twin Shadow – Eclipse
Tobias Jesso Jr. – Goon
Jamie xx – In Colour - Preview White Label
Lower Dens – Escape From Evil
Reptar – Lurid Glow
Sufjan Stevens – Carrie & Lowell
Death Cab for Cutie – Kintsugi
The Soft Moon – Deeper
Godspeed You! Black Emperor – Asunder, Sweet and Other Distress
Nils Frahm – Solo
Jeff The Brotherhood – Wasted On The Dream
Houndmouth – Little Neon Limelight
Action Bronson – Mr. Wonderful
Happyness – Weird Little Birthday
Clark – Flame Rave
Courtney Barnett – Sometimes I Sit and Think, And Sometimes I Just Sit
Moon Duo – Shadow of the Sun
Grooms – Comb the Feelings Through Your Hair
Badbadnotgood – SOUR SOUL
Susanne Sundfør – Ten Love Songs
Modest Mouse – Strangers to Ourselves
Andrew Bird – Echolocations: Canyon
Foreign Fields – What I Kept in Hiding
Purity Ring – another eternity
Will Butler – Policy
Steve Gunn – Seasonal Hire
Dan Deacon – Gliss Riffer
Sun Glitters – Galaxy (feat. Sarah P.)
Interpol – Spotify Sessions
Cherokee – Teenage Fantasy - EP
José González – Vestiges & Claws
Grooms – Comb the Feelings Through Your Hair
Susanne Sundfør – Ten Love Songs
J Dilla – Jay Dee a.k.a. J Dilla 'The King Of Beats' (Box Set)
Public Service Broadcasting – The Race For Space
Drake – If You're Reading This It's Too Late
Zola Jesus – Hunger
Father John Misty – I Love You, Honeybear
Natalie Prass – Natalie Prass
St. Vincent – St. Vincent (Deluxe Edition)
S. Carey – Supermoon
Shy Girls – 4wz
Howard (US) – Religion
Zun Zun Egui – Shackles Gift
Pond – Man It Feels Like Space Again
Sleater-Kinney – No Cities to Love
Meat Wave – Brother
Enter Shikari – The Mindsweep
Menace Beach – Ratworld
Sylvan Esso – Spotify Session
Nathaniel Rateliff – Closer
The Dodos – Individ
Belle & Sebastian – Girls in Peacetime Want to Dance
Viet Cong – Viet Cong
Liam Hayes – Slurrup
Panda Bear - Panda Bear Meets The Grim Reaper
California X – Nights In The Dark
Ghost Culture – Ghost Culture
Silk Rhodes – Silk Rhodes
