Earl Sweatshirt – Some Rap Songs
Jacco Gardner – Somnium
Songs: Ohia – The Lioness (Deluxe Edition)
Calexico – The Black Light (20th Anniversary Edition)
Art Brut – Wham! Bang! Pow! Let's Rock out!
Ed Harcourt – Beyond the End
My Brightest Diamond – A Million and One
SALES – Forever & Ever
The Beatles White Album Experience
Charlie Haden & Brad Mehldau – Long Ago And Far Away (Live)
Chris Cornell – Chris Cornell (Deluxe Edition)
Jeffrey Zeigler – The Sound of Science
The Glands – Double Coda
Sufjan Stevens – Lonely Man of Winter
J Mascis – Elastic Days
The Beatles – The Beatles
Sun Kil Moon – This Is My Dinner
boygenius - boygenius
Maggie Roche – Where Do I Come From
Ty Segall – Fudge Sandwich
Julia Holter – Aviary
Thom Yorke – Suspiria (Music for the Luca Guadagnino Film)
Mark Kozelek – Mark Kozelek
Oh Pep! – I Wasn't Only Thinking About You...
Phony Ppl – mō'zā-ik.
Peter Bjorn and John – Darker Days
Elle King – Shake The Spirit
Tom Morello – The Atlas Underground
BRONCHO – Bad Behavior
Ambrose Akinmusire – Origami Harvest
The Dodos – Certainty Waves
John Grant – Love Is Magic
Kurt Vile – Bottle It In
Adrianne Lenker – abysskiss
Wolfgang Muthspiel – Where The River Goes
Swearin' – Fall into the Sun
Hockey Dad – Blend Inn
Villagers – The Art Of Pretending To Swim 2
Liars – Titles With The Word Fountain (TFCF Deluxe Edition) 2
Lonnie Holley – MITH
Richard Swift – The Hex
Christian Sands – Facing Dragons
Metric – Art of Doubt
Prince – Piano & A Microphone 1983
Mountain Man – Magic Ship
6LACK – East Atlanta Love Letter
Alejandro Escovedo – The Crossing
St. Paul & The Broken Bones – Young Sick Camellia
Shannen Moser – I'll Sing
Mitski – Be the Cowboy
Roy Montgomery – Suffuse
Antonio Vivaldi – ANNO: Four Seasons by Anna Meredith & Antonio Vivaldi
Trevor Powers – Mulberry Violence
Great Lake Swimmers – The Waves, The Wake
Death Cab for Cutie – Thank You for Today
Animal Collective – Tangerine Reef
The Internet – Hive Mind
El Ten Eleven – Banker's Hill
Tony Molina – Kill the Lights
Thin Lips – Chosen Family
Phantastic Ferniture – Phantastic Ferniture
Israel Nash – Lifted
Ty Segall and White Fence – Joy
Self Defense Family – Have You Considered Punk Music
Wet – Still Run
Luluc – Sculptor
The Ophelias – Almost
The National – Boxer Live in Brussels
Dirty Projectors – Lamp Lit Prose
Jim James – Uniform Distortion 2
AJ Ghent [ j-ent ] – The Neo Blues Project
Yuno – Moodie
Jay Rock – Redemption
SOPHIE – OIL OF EVERY PEARL'S UN-INSIDES
Buddy Guy – The Blues Is Alive And Well
Lykke Li – so sad so sexy
Jorja Smith – Lost & Found
Snail Mail – Lush
serpentwithfeet – soil
River Whyless – Kindness, A Rebel
Oneohtrix Point Never – Age Of
LUMP – LUMP
Albin Lee Meldau – About You
Natalie Prass – The Future And The Past
Tancred – Nightstand
Neko Case – Hell-On
Niklas Paschburg – Oceanic
Father John Misty – God's Favorite Customer
Pusha T – DAYTONA
Cut Worms – Hollow Ground
Remember Sports – Slow Buzz
Nick Grant – Dreamin' Out Loud
Parquet Courts – Wide Awake!
Courtney Barnett – Tell Me How You Really Feel
David Grubbs – Failed Celestial Creatures
Low Cut Connie – Dirty Pictures (Part 2)
Stephen Malkmus & The Jicks – Sparkle Hard
Brad Mehldau Trio – Seymour Reads the Constitution!
Los Texmaniacs – Cruzando Borders
illuminati hotties – Kiss Yr Frenemies
Simone Dinnerstein – Circles: Piano Concertos by Bach + Glass
Beach House – 7
Frank Turner – Be More Kind
Sigur Rós – Route One
Leon Bridges – Good Thing
Gaz Coombes – World’s Strongest Man
Eleanor Friedberger – Rebound
Shakey Graves – Can't Wake Up
Middle Kids – Lost Friends
Pinkshinyultrablast – Miserable Miracles
Forth Wanderers – Forth Wanderers
Half Waif – Lavender
Janelle Monáe – Dirty Computer
Tom Rush – Voices
Grouper – Grid of Points
Speedy Ortiz – Twerp Verse
DRINKS – Hippo Lite
Pizzagirl – An Extended Play
Exitmusic – The Recognitions
Ashley Paul – Lost in Shadows
Whyte Horses – Empty Words
Hinds – I Don't Run
Beak> – L.A. Playback
King Tuff – The Other
Goldmund – Occasus
L.A. Salami – The City of Bootmakers
Laura Veirs – The Lookout
A Place To Bury Strangers – Pinned
Juliana Hatfield – Juliana Hatfield Sings Olivia Newton-John
Say Sue Me – Where We Were Together
Unknown Mortal Orchestra – Sex & Food
Charlotte Day Wilson – Stone Woman
Ty Segall – Freedom's Goblin
Wye Oak – The Louder I Call, the Faster It Runs
Hop Along – Bark Your Head Off, Dog
Dark Times – Tell Me What I Need
Clarice Jensen – For This From That Will Be Filled
Christina Vantzou – No. 4
The Voidz – Virtue
Sergei Rachmaninoff – Rachmaninov: 24 Preludes
Frankie Cosmos – Vessel
Jean Grae – Everything's Fine
Orquesta Akokán – Orquesta Akokán
Sunflower Bean – Twentytwo in Blue
Caitlin Canty – Motel Bouquet
The Lemon Twigs – Foolin' Around / Tailor Made
Jukebox The Ghost – Off To The Races
Lucy Dacus – Historian
Jack White – Boarding House Reach 2
Sun Ra – Of Abstract Dreams
Mount Eerie – Now Only
Yo La Tengo – There's a Riot Going On
David Byrne – American Utopia
Steve Reich – Steve Reich: Drumming
Young Fathers – Cocoa Sugar
Brad Mehldau – After Bach
Suuns – Felt
Anna von Hausswolff – Dead Magic
Sorority Noise – YNAAYT
Superorganism – Superorganism
Tiny Moving Parts – Swell
The Men – Drift
The Lovely Eggs – This Is Eggland
Hailu Mergia – Lala Belu
S. Carey – Hundred Acres
Kronos Quartet – Landfall
Ought – Room Inside the World
Marlon Williams – Make Way for Love
Loma – Loma
Car Seat Headrest – Twin Fantasy
Hockey Dad – Blend Inn
MGMT – Little Dark Age
The Spook School – Could It Be Different?
Mimicking Birds – Layers of Us
Rhye – Blood
Erik Satie – Satie: Complete Piano Works, Vol. 2
Steve Reich – Steve Reich: Pulse / Quartet
Porches – The House
Django Django – Marble Skies
José González – & The Brite Lites at Svenska Grammofonstudion
Helado Negro – Island Universe Story Four
Nils Frahm – All Melody
Khruangbin — Con Todo El Mundo
Strand of Oaks – Harder Love
Ron Gallo – Really Nice Guys
First Aid Kit – Ruins
Belle & Sebastian – How to Solve Our Human Problems (Part 2)
Shopping – The Official Body
Tune-Yards – I can feel you creep into my private life
Jonny Greenwood — Phantom Thread (Original Motion Picture Soundtrack)